                         
   P XXXX   G   E        
   X    X   X   X   XXX  
   X    X   X O X   X    
   X E  X   X   X   X    
   X    X   X   XXXXX    
   X    X S X   X        
   X    X   X   X   G    
   X    X   X   X        
   X    X   X   X   Z X  
   X    X   X   XXXXXXX   
   X    X   X   X     X  
   X G  X   X   X  E  X  
   X    X   XXXXX     X  
   X S  X   J   X     X  
   X    X       XXXXXXX  
   X    X                
   XXXXX                
XXXXXXXXXXXXXXXXXXXXXXXXX
