                         
   P   XXXXX  X E  X   
   X       X   XXXXX         
   X   G   X   X    Z    
   X       X   XXXX XXX  
   X       X   X  X E    
   X   E   XXXXX  X      
   X       X  S   X  G   
   XXXXXX  X      X      
   X       X  O   X      
   X       X      X      
   X   G   X      X  J   
   X  S    X      X      
   X       X   XXXX      
   X   S   X   X S       
   X       X   X        
   X       X   X        
XXXXXXXXXXXXXXXXXXXXXXXXX
