                         
   P XXXX  XXXXXX    J    
   X    X  X    X  XXXXX  
   X    X  X E  X  X   X  
   X    X  X    X  X G X  
   X G  XXXX    X  X   X  
   X         XXXXX  X   X  
   X     S      E   X   X  
   X  XXXXXXXX     X   X  
   X  X        XXXXX   X  
   X  X  G   X  S   XXX  
   X  X S    X          X 
   X  X      X   O   S  X 
   X  X      X          X 
   X  X  O   XXXX  XXXXX   
   X  X                 X  
   X  X            E    X  
XXXXXXXXXXXXXXXXXXXXZ  Z  
