                                
   X   X      G     X    O     
   X   X  XXXXXXXX XXXXXX      
   X   X        X  X    X      
   X GXXXX       X  X  E X     
   X        J    X  X    X     
   X   XXXXXXXXXXX  XXXXXXXXXX 
   X      P     O            Z 
   XXXXXXXXXXXXXXXXXXXXXXXX   
      SSS   XXXXXXXX   SSS     
   XXXXX   X      X   XXXXXXX  
   X       X      X           X
   X   G   X      X   G       X
   X       X      X           X
   XXXXXXXXXXXXXXXXXXXXXXXXXXXX
                                
                               Z
XXXXXXXXXXXXXXXXXXXXXXXXXXXXXXXX
