   X  P         J       
   X  XXXXXXX  XXXXXSSX 
   X  X   G  X X      X 
   X  X      X X  O   X 
   X  X      X X      X 
   X  X  XXXXXX X       
   X  X  X    X X          SSSSS
   X  X  X    X XXXXXXXX
   X  X  X    X        
   X  X  X    X   G    
   X  X  X    X      Z      E
   X  X  X    X   XXXXXXXXXXXXXXXXXX
   X  X  X    X        
   X  X  X    X        
   X  X  X    X        
   X  X  X    X        
   X  X  X    X        
   XXXXXX    X        
              X        
 XXXXXXXXXXXXXXXXXXXXXXXXXXXXX
