   XXXXXXXXXXXXXXXXXXXXXXXXXX
   X        G      O      X
   X   XXXXXXXXXXXXXXX    X
   X   X    P         X   X
   X   X  XXXXXXXX    X   X
   X   X  X      X    X   X
   X   X  X  G   X    X   X
   X   X  X      X    X   X
   X   X  X  XXXXXXXX X   X
   X   X  X           X   X
   X   X  X   J       X   X
   X   X  X           X   X
   X   X  X  XXXXXXXXXX   X
   X   X  X            Z  X
   X   X  X  XXXXXXXXXXXXX
   X   X                X 
   X   X                X 
   X   X                X 
   X   X                X 
   XXXXXXXXXXXXXXXXXXXXXXX
