                         
   P  XXXXX   G   J      
   X      X   X   X      
   X   G  X   X   X   XXXXX  
   X      X   X   X   X   X  
   X      X   X   X   X E X  
   X   E  X   X   X   X   X  
   X    S XXXXX   XXXXX   X  
   X      X       X   X   X  
   X      X   G   X   X   X  
   X  S   X       X   X   X  
   X      X       X   XXXXX  
   X      X    Z  X   X      
   X   O  XXXXXXXX    X     
   X                  X XXX  
   X   G   XXXXXX     X      
   XXXXXXX    S       X      
XXXXXXXXXXXXXXXXXXXXXXXXX
