                         
    G      E       O     
         XXXXXXXX XXXXX  
   X              X    X 
   X   XXXX    XXXXX   X 
   X        G       E  X 
   X   XXXXX   XXXXXXXX 
   X      P               
   X    S    J           
   XXXXXXXXXXXXXXXX     
      SSS   XXXX    SS   
   XXXXX   X   X XXXXXX 
           X   X        
    G      X   X    G   
   XXXXXXXXXXXXXXXX     
                         
          E        O   Z 
XXXXXXXXXXXXXXXXXXXXXXXXX
