   X            J       Z
   X  XXXXXXX  XXXXXXXX 
   X  X   G  X X      X 
   X  X      X X  O   X 
   X  X      X X      X 
   X  X  XXXXXX X      X 
   X  X  X    X X      X 
   X  X  X    X XXXXXXXX
   X  X  X    X        
   X  X  X    X   G    
   X  X  X    X        
   X  X  X    X   XXXXX
   X  X  X    X        
   X  X  X    X        
   X  X  X    X        
   X  X  X    X        
   X  P  X    X        
   XXXXXX    X        
              X        
 XXXXXXXXXXXXXXXXXXXXX
