                         
   P   XXXXX  J  G  E    
   X       X  X   X     
   X   E   X  X   XXXXX  
   X       X  X   X   X  
   X   XXXXX  X  X   X  
   X    S     X  X O X  
   X       XXX   X   X  
   X        X    X   X  
   X      G X    X   X  
   X        X    X   X  
   X      XXXXX  X   X  
   X      X   X  X   X  
   X  G   X   X  X   X  
   X  S   X   X  X S X  
   X          X  X   X  
   X          X  X   X  
   XXXXXX    ZXXXXXX     
XXXXXXXXXXXXXXXXXXXXXXXXX
