   XXXXXXXXXXX            
   X         X      G    
   X   E     X  XXXXXXXX
   X         X       J  
   X   XXXXX X   P      
   X   X   X X  XXXXXXX 
   X   X   X X         X
   X   X   X X         X
   X   X   X X  G      X
   X   X   X X  XXXXX  X
   X   X   X X      X  X
   X   X   X X      X  X
   X   X   X X  O   X  X
   X   X   X X      X  X
   X   X   X X      X  X
   X   X   X X  XXXXX  X
   X   X   X X         X
   X   X   X X         X
   X   X   X XZ        X
   XXXXXXXXXXXXXXXXXXXX
