
                                                   G
                                                XXXXXX 
                   G                                     XXXXXXXXXXXXXXXXXXXX
        P      XXXXXXXXXXX                  J         XXXXXXXXXXXXXXXXXXXXXXXXXX                  XXXXX
      XXXXX                             XXXXXXXXXXXXXXXXXXXXXXXXXXXXXXXXXXXX                     XXXXXX
                            XXXXXXXX                 XXXXXXXXXXXXXXXX             J             XXXXXXX
  X        XXXXXXXX  XXXXXXXX XXXXXXXXXXXXXXXXXXX                              XXXXXXXXXXXXXX   XXXXXXX
XXXXXXXXXXXXXXXXXXX  XXXXXXXXXXXXXXXXXXXXXXXXXXXXXXXXXXXXXX    O            XXXXXXXXXXXXXXXXXX      Z
XXXXXXXXXXXXXXXXXXXSSXXXXXXXXXXXXXXXXXXXXXXXXXXXXXXXXXXXXXXXXXXXXXXXXXXXXX  XXXXXXXXXXXXXXXXXX  XXXXXXXXXXX       
XXXXXXXXXXXXXXXXXXXXXXXXXXXXXXXXXXXXXXXXXXXXXXXXXXXXXXXXXXXXXXXXXXXXXXXXXXSSXXXXXXXXXXXXXXXXXXSSXXXXXXXXXXX
