   XXXXXXXXXXXXXXXXXXXXXXXXXX
   X      G   P           X
   X   XXXXXXXX   XXXXX   X
   X   X      X   X   X   X
   X   X  O   X   X J X   X
   X   X      X   X   X   X
   X   X  XXXXX   X   X   X
   X   X          X   X   X
   X   X   XXXXXXXXX   X  
   X   X   X      X   X  
   X   X   X  G   X   X  
   X   X   X      X   X  
   X   X   X  XXXXX   X  
   X   X   X         X  
   X   X   X  XXXXXXXX  
   X   X              Z  
   X   X  XXXXXXXXXXXXXXX
   X   X                 
   X   X                 
   XXXXXXXXXXXXXXXXXXXXXX
