                         
   P XX    XX    XX      
   X  X E  X     X   G   
   X  X    X  G  X   X   
   X  X S  X     X   X   
   X  XX  XX  O  X   X   
   X  X        XXX   X   
   X  X   G     X    X   
   X  X    S    X    X   
   X  XXXXXXX   X    X   
   X  X     X   X    X   
   X  X  E  X   X    X   
   X  X S   X   X    X   
   X  X     X   X    X   
   X  X  O  X   X    X   
   X  XXXXXXX   X    X   
   X        G   X    X Z  G  E X  
XXXXXXXXXXXXXXXXXXXXXXXXXXXXXXX
