                         
   P XXXX   J          Z  
   X    XXXX X   G      XX 
   X    X  X X   X      X  
   X G  X  X XXXX   O   X  
   X    X  X    X   X   X  
   X    X  X E  XXXX    X  
   X    X  X    X       X  
   X    XXXXXXXX    G   X  
   X          X    X    X  
   X   G      X    X    X  
   X          X    XXXXXX  
   X       S  X        X   
   X          X   S    X   
   X      XXXXX       X    
   X    J            X    
   X                X    
XXXXXXXXXXXXXXXXXXXXXXXXX
