                        X     
                        X     
   G    XXXXXXXXXXXXXXXX     
        X              X     
   J    X   E    G     X     
 XXXXXXXX   XXXXXXXX   X     
 X      P          X   X     
 X  XXXXXXX X  O   X   X     
 X  X       X      X   X     
 X  X   SSS X      X   X     
 X  X       X      X   X     
 X  X       X      X   X     
 X  XXXXXXX X      X   X     
 X        X X      X   X     
 X    G   X X      X   X     
 X        X X   E   J  X     
 XXXXXXXXXX XXXXXXXXX   X    
 X G   E              Z  X    
 XXXXXXXXXXXXXXXXXXXXXXXXX   
 X                          
